1111111111111
10P1000C001C1
1001011110101
1C000C1E00001
1111111111111